15 18
##################
#@#.......#......#
#.#.####..#.####.#
#.#.#.....#......#
#...#.##########.#
#.#.#............#
#.#.########.....#
#...#...........!#
#####...##########
#...#............#
#.#.########.....#
#.#..............#
#.##########.#####
#................#
##################
